##########
##      ##
# #    # #
#  #  #  #
#   ##   #
#   ##   #
#  #  #  #
# #    # #
##      ##
##########